BIG DATA - נתוני עתק: 
TCP-IP רשתות: חשבון אינפני' להנדסה 1, קורס קדם במתמטיקה להנדסה וטכנולוגיה, מבוא לתקשרת מחשבים
UNIX מערכות: חשבון אינפני' להנדסה 1, מבנה נתונים א', מבוא למדעי המחשב, מבנה המחשב, מבוא למחשבים, מערכות ספרתיות, מערכות הפעלה, קורס קדם במתמטיקה להנדסה וטכנולוגיה
c  סדנא מתקדמת ב: חשבון אינפני' להנדסה 1, סדנא ב-++C, מבנה נתונים א', מבוא למדעי המחשב, מבנה המחשב, מבוא למחשבים, מערכות ספרתיות, מערכות הפעלה, קורס קדם במתמטיקה להנדסה וטכנולוגיה
אבטחת איכות תוכנה ובדיקות תוכנה: חשבון אינפני' להנדסה 1, סדנא ב-++C, מבנה נתונים א', מבוא למדעי המחשב, מבוא להנדסת תוכנה, מבוא למחשבים, אלגברה לינארית א, קורס קדם במתמטיקה להנדסה וטכנולוגיה
אוטומטים ושפות פורמליות: חשבון אינפני' להנדסה 1, מבנה נתונים א', מבוא למדעי המחשב, מבוא למחשבים, קורס קדם במתמטיקה להנדסה וטכנולוגיה, מתמטיקה בדידה, לוגיקה מתמטית
איחזור מידע: חשבון אינפני' להנדסה 1, מבנה נתונים ב', מבוא לבינה מלאכותית ומדע הנתונים, מבנה נתונים א', מבוא למדעי המחשב, מבוא למחשבים, קורס קדם במתמטיקה להנדסה וטכנולוגיה
אלגברה לינארית א: קורס קדם במתמטיקה להנדסה וטכנולוגיה
אלגברה לינארית ב: קורס קדם במתמטיקה להנדסה וטכנולוגיה, אלגברה לינארית א
אלגוריתמיקה מקבילית: ניתוח אלגוריתמים וסיבוכיות, מבנה נתונים ב', חשבון אינפני' להנדסה 1, מבנה נתונים א', מבוא למדעי המחשב, מבוא למחשבים, אלגברה לינארית א, אלגברה לינארית ב, אוטומטים ושפות פורמליות, קורס קדם במתמטיקה להנדסה וטכנולוגיה, חשבון אינפיני' להנדסה 2, מתמטיקה בדידה, לוגיקה מתמטית
אנגלית בסיסי: אנגלית טרום בסיסי א, אנגלית טרום בסיסי ב
אנגלית טרום בסיסי א: 
אנגלית טרום בסיסי ב: 
אנגלית למדעי  המחשב: אנגלית בסיסי, אנגלית טרום בסיסי א, אנגלית מתקדמים ב, אנגלית טרום בסיסי ב, אנגלית מתקדמים א
אנגלית מתקדמים א: אנגלית בסיסי, אנגלית טרום בסיסי א, אנגלית טרום בסיסי ב
אנגלית מתקדמים ב: אנגלית בסיסי, אנגלית טרום בסיסי א, אנגלית טרום בסיסי ב, אנגלית מתקדמים א
אקסלנטים: חשבון אינפני' להנדסה 1, מבנה נתונים ב', מבנה נתונים א', מבוא למדעי המחשב, מבוא למחשבים, קורס קדם במתמטיקה להנדסה וטכנולוגיה
בינה מלאכותית וישומה: חשבון אינפני' להנדסה 1, מבנה נתונים ב', מבוא לבינה מלאכותית ומדע הנתונים, מבנה נתונים א', מבוא למדעי המחשב, מבוא למחשבים, קורס קדם במתמטיקה להנדסה וטכנולוגיה
בסיסי נתונים: 
הכרת משאבי הספריה להנדסה ומדעי המחשב: 
הנדסת מערכות חלונות: חשבון אינפני' להנדסה 1, סדנא ב-++C, מיני פרויקט במערכות חלונות, מבנה נתונים א', מבוא למדעי המחשב, מבוא למחשבים, קורס קדם במתמטיקה להנדסה וטכנולוגיה
הנדסת תוכנה  לאינטרנט: 
הנדסת תכנה: חשבון אינפני' להנדסה 1, סדנא ב-++C, מבנה נתונים א', מבוא למדעי המחשב, מבוא להנדסת תוכנה, מבוא למחשבים, אלגברה לינארית א, קורס קדם במתמטיקה להנדסה וטכנולוגיה
הסתברות: 
חישוביות ומורכבות החישובים: ניתוח אלגוריתמים וסיבוכיות, מבנה נתונים ב', חשבון אינפני' להנדסה 1, מבנה נתונים א', מבוא למדעי המחשב, מבוא למחשבים, אלגברה לינארית א, אלגברה לינארית ב, אוטומטים ושפות פורמליות, קורס קדם במתמטיקה להנדסה וטכנולוגיה, חשבון אינפיני' להנדסה 2, מתמטיקה בדידה, לוגיקה מתמטית
חשבון אינפיני' להנדסה 2: חשבון אינפני' להנדסה 1, קורס קדם במתמטיקה להנדסה וטכנולוגיה
חשבון אינפני' להנדסה 1: קורס קדם במתמטיקה להנדסה וטכנולוגיה
יסודות באבטחת תוכנה: סדנא ב-++C, מבוא למדעי המחשב, מבנה המחשב, מערכות ספרתיות, מבוא למחשבים, מבוא לאבטחת מידע
יסודות לאבטחת רשתות: חשבון אינפני' להנדסה 1, סדנא ב-++C, מבוא למדעי המחשב, מבנה המחשב, מבוא למחשבים, מערכות ספרתיות, מבוא לאבטחת מידע, מבוא לתקשרת מחשבים, קורס קדם במתמטיקה להנדסה וטכנולוגיה
כריית מידע - למדה"מ: חשבון אינפני' להנדסה 1, מבנה נתונים ב', מבוא לבינה מלאכותית ומדע הנתונים, מבנה נתונים א', מבוא למדעי המחשב, מבוא למחשבים, קורס קדם במתמטיקה להנדסה וטכנולוגיה
לוגיקה מתמטית: קורס קדם במתמטיקה להנדסה וטכנולוגיה
מבוא לאבטחת מידע: סדנא ב-++C, מבוא למדעי המחשב, מבנה המחשב, מבוא למחשבים, מערכות ספרתיות
מבוא לבינה מלאכותית ומדע הנתונים: חשבון אינפני' להנדסה 1, מבנה נתונים ב', מבנה נתונים א', מבוא למדעי המחשב, מבוא למחשבים, קורס קדם במתמטיקה להנדסה וטכנולוגיה
מבוא להנדסת תוכנה: חשבון אינפני' להנדסה 1, סדנא ב-++C, מבנה נתונים א', מבוא למדעי המחשב, מבוא למחשבים, אלגברה לינארית א, קורס קדם במתמטיקה להנדסה וטכנולוגיה
מבוא למדעי המחשב: מבוא למחשבים
מבוא למחשבים: 
מבוא לרברסינג: 
מבוא לתקשרת מחשבים: חשבון אינפני' להנדסה 1, קורס קדם במתמטיקה להנדסה וטכנולוגיה
מבנה המחשב: מערכות ספרתיות
מבנה נתונים א': חשבון אינפני' להנדסה 1, מבוא למחשבים, קורס קדם במתמטיקה להנדסה וטכנולוגיה, מבוא למדעי המחשב
מבנה נתונים ב': חשבון אינפני' להנדסה 1, מבנה נתונים א', מבוא למדעי המחשב, מבוא למחשבים, קורס קדם במתמטיקה להנדסה וטכנולוגיה
מבנה שפות תכנה: חשבון אינפני' להנדסה 1, סדנא ב-++C, מבנה נתונים א', מבוא למדעי המחשב, מבוא למחשבים, קורס קדם במתמטיקה להנדסה וטכנולוגיה
מהשכלה לתעסוקה - מיומניות וכישורים: 
מיני פרויקט בבסיסי נתונים: בסיסי נתונים
מיני פרויקט במבוא להנדסת תוכנה: חשבון אינפני' להנדסה 1, סדנא ב-++C, מבנה נתונים א', מבוא למדעי המחשב, מבוא למחשבים, אלגברה לינארית א, קורס קדם במתמטיקה להנדסה וטכנולוגיה
מיני פרויקט במערכות חלונות: חשבון אינפני' להנדסה 1, סדנא ב-++C, מבנה נתונים א', מבוא למדעי המחשב, מבוא למחשבים, קורס קדם במתמטיקה להנדסה וטכנולוגיה
מכינה בפיזיקה למחשבים: 
מעבדה במבנה המחשב: מערכות ספרתיות
מערכות הפעלה: חשבון אינפני' להנדסה 1, מבנה נתונים א', מבוא למדעי המחשב, מבנה המחשב, מערכות ספרתיות, מבוא למחשבים, קורס קדם במתמטיקה להנדסה וטכנולוגיה
מערכות זמן אמת ותכנות מקבילי: חשבון אינפני' להנדסה 1, סדנא ב-++C, מבנה נתונים א', מבוא למדעי המחשב, מבנה המחשב, מערכות ספרתיות, מבוא למחשבים, מערכות הפעלה, קורס קדם במתמטיקה להנדסה וטכנולוגיה
מערכות להרצת קוד בסביבה בטוחה: סדנא ב-++C, מבוא למדעי המחשב, מבנה המחשב, מערכות ספרתיות, מבוא למחשבים, מבוא לאבטחת מידע
מערכות ספרתיות: 
משוואות דפרנציאליות: חשבון אינפני' להנדסה 1, קורס קדם במתמטיקה להנדסה וטכנולוגיה, אלגברה לינארית א
מתמטיקה בדידה: קורס קדם במתמטיקה להנדסה וטכנולוגיה
ניהול פרויקטים ובקרת איכות: 
ניתוח אלגוריתמים וסיבוכיות: חשבון אינפני' להנדסה 1, מבנה נתונים ב', מבנה נתונים א', מבוא למדעי המחשב, מבוא למחשבים, אלגברה לינארית א, אלגברה לינארית ב, אוטומטים ושפות פורמליות, קורס קדם במתמטיקה להנדסה וטכנולוגיה, חשבון אינפיני' להנדסה 2, מתמטיקה בדידה, לוגיקה מתמטית
ניתוח ותיכון ממשקי תוכנה: 
סדנא ב- java: מבוא למחשבים, סדנא ב-++C, מבוא למדעי המחשב
סדנא ב-++C: מבוא למחשבים, מבוא למדעי המחשב
סטטיסטיקה למהנדסים: הסתברות
סמינר להנדסת תכנה: ניתוח אלגוריתמים וסיבוכיות, מבנה נתונים ב', חשבון אינפני' להנדסה 1, מבנה נתונים א', מבוא למדעי המחשב, מבוא למחשבים, אלגברה לינארית א, אלגברה לינארית ב, בסיסי נתונים, אוטומטים ושפות פורמליות, קורס קדם במתמטיקה להנדסה וטכנולוגיה, חשבון אינפיני' להנדסה 2, מתמטיקה בדידה, לוגיקה מתמטית
סמינריון למדעי המחשב: 
עיצוב ותכנות מונחי עצמים להנדסה: חשבון אינפני' להנדסה 1, מבנה נתונים ב', סדנא ב-++C, מבנה נתונים א', מבוא למדעי המחשב, מיני פרויקט במבוא להנדסת תוכנה, מבוא למחשבים, אלגברה לינארית א, קורס קדם במתמטיקה להנדסה וטכנולוגיה
עקרונות שפות תכנה: חשבון אינפני' להנדסה 1, סדנא ב-++C, מבנה נתונים א', מבוא למדעי המחשב, מבוא למחשבים, תכנות פונקציונלית ולוגית, קורס קדם במתמטיקה להנדסה וטכנולוגיה, לוגיקה מתמטית
פיזיקה ב' להנדסת מחשבים: פיזיקה להנדסת מחשבים
פיזיקה להנדסת מחשבים: 
פרויקט גמר בהנדסת מחשבים: תכנון- פרויקט גמר בהנדסת מחשבים
קומפיילרים ומתרגמים: חשבון אינפני' להנדסה 1, מבנה נתונים א', מבוא למדעי המחשב, מבוא למחשבים, אוטומטים ושפות פורמליות, קורס קדם במתמטיקה להנדסה וטכנולוגיה, מתמטיקה בדידה, לוגיקה מתמטית
קורס קדם במתמטיקה להנדסה וטכנולוגיה: 
רשתות מחשבים בגישה מחקרית: 
רשתות נוירונים ולמידה עמוקה: חשבון אינפני' להנדסה 1, מבנה נתונים ב', מבוא לבינה מלאכותית ומדע הנתונים, מבנה נתונים א', מבוא למדעי המחשב, מבוא למחשבים, אלגברה לינארית א, אלגברה לינארית ב, כריית מידע - למדה"מ, קורס קדם במתמטיקה להנדסה וטכנולוגיה, חשבון אינפיני' להנדסה 2
תכנון- פרויקט גמר בהנדסת מחשבים: 
תכנות פונקציונלית ולוגית: חשבון אינפני' להנדסה 1, מבנה נתונים א', מבוא למדעי המחשב, מבוא למחשבים, קורס קדם במתמטיקה להנדסה וטכנולוגיה, לוגיקה מתמטית
